###########
#A...#...B#
#.#.#.#.#.#
#.#...#...#
#.#####.#.#
#.......#.#
###########